11111111111
100000000N1
11111111111