1111111
1000001
1001001
1000101
1N00001
1111111