NO ./assets/brick_wall_64x64.xpm
SO ./assets/brick_wall_64x64.xpm
EA ./assets/brick_wall_64x64.xpm
WE ./assets/brick_wall_64x64.xpm

F 220,100,0
C 225,30,255


1111111
1000001
10N1011
1000001
1000001
1111111