NO ./assets/brick_wall_64x64.xpm
SO ./assets/brick_wall_64x64.xpm
EA ./assets/brick_wall_64x64.xpm
WE ./assets/brick_wall_64x64.xpm

F 220,100,0
C 225,30,255

1111    11111
1N01111110000
1000000000001
100000000000111111
111111100100001
100000000000111111
1000000000001
1000000000001
1111111101111
101
101
111