NO ./assets/brick_wall_64x64.xpm
SO ./assets/brick_wall_64x64.xpm
EA ./assets/brick_wall_64x64.xpm
WE ./assets/brick_wall_64x64.xpm

F 220,100,0
C 225,30,255

11111111111111
10000000000001
10111011101111
10100000100001
10101110111011
101000W0000001
10101110111011
10100000000001
10111011101111
10000000000001
11111111111111