NO ./assets/immondice.xpm
SO ./assets/gradient.xpm
EA ./assets/brick_wall_64x64.xpm
WE ./assets/brick_wall_64x64_darken.xpm

F 220,100,0
C 125,30,253

11111
10001
10S01
10001
10001
10001
10001
10001
10001
10101
10001
11111