NO ./assets/brick_wall_64x64.xpm
SO ./assets/brick_wall_64x64_darken.xpm
EA ./assets/immondice.xpm
WE ./assets/gradient.xpm

F 220,100,0
C 125,30,253

11111111111111
1000000N000001
10111011101111
10100000100001
10101110111011
101000000000011111
101011101110110001
101000000000010001
101110111011111111
100000011000101
1111111  111111