NO ./assets/brick_wall_64x64.xpm
SO ./assets/brick_wall_64x64_darken.xpm
EA ./assets/immondice.xpm
WE ./assets/brick_wall_64x64_old.xpm

F 220,100,0
C 125,30,253

111111
100E01
100001
100001
100001
111111