
C 120,150,255

NO ./assets/brick_wall_64x64.xpm
SO ./assets/brick_wall_64x64_darken.xpm
EA ./assets/brick_wall_64x64.xpm
WE ./assets/brick_wall_64x64_darken.xpm

F 120,120,120


11111111111111
1S000000000001
10111011101111
10100000100001
10101110111011
101000010000011111
1010111 1110110001
101000010000010001
101110111011111111
100000011000101
1111111  111111