NO ./assets/brick_wall_64x64.xpm
SO ./assets/brick_wall_64x64.xpm
EA ./assets/brick_wall_64x64_darken.xpm
WE ./assets/brick_wall_64x64_darken.xpm

F 120,120,120
C 120,150,255

                1111111111111111
                1000000000000001
                1000000S00000001
                1000000000000001
                1000000000000001
                1111111001111111
                1000000000000001
                1000000000000001
                1000000000000001
                1000000000000001
                1000000000000001
                1000000000000001
                1000000000000001
                1000000000000001
                1000000000000001
                1000000000000001
                1000000000000001
                1000000000000001
                1000000000000001
                1000000000000001
       1111111111100111111110011111111111
       100000000000001    100000000000001
       100000000000001    100000000000001
       100000000000001    100000000000001
       100000000000001    100000000000001
       100000000000001    100000000000001
       100000000000001    100000000000001
       111111111111111    111111111111111