NO ./assets/brick_wall_64x64.xpm
SO ./assets/brick_wall_64x64.xpm
EA ./assets/brick_wall_64x64.xpm
WE ./assets/brick_wall_64x64.xpm

F 220,100,0
C 225,30,255

11111111111111
10S00000000001
10111011101111
10100000100001
10101110111011
101000000000011111
101011101110110001
101000000000010001
101110111011111111
10000000000001
11111111111111