NO ./assets/brick_wall_64x64.xpm
SO ./assets/brick_wall_64x64.xpm
EA ./assets/brick_wall_64x64.xpm
WE ./assets/brick_wall_64x64.xpm

F 220,100,0
C 225,30,255


111111111111111111111111111111111111111
100000000000000000000000000000000000001
100000000000000000000000000000000000001
100000000000000000000000000000000000001
100000000000000000000000000000000000001
100000000000000000000000000000000000001
100000000000000000000000000000000000001
100000000000000000010000000000000000001
100000000000000100000100000000000000001
100000000000000100000000000000000000001
100000000000000000000000000000000000001
100000000000000000000000000000000000001
100000000000000000000000000000000000001
100000000000000000000000000000000000001
100000000000000000100000100000000000001
100000000000000000000000000000000000001
100000000000000000000000000000000000001
10000000000000N000000000000000000000001
100000000000000000000000000000000000001
100000000000000000000000000000000000001
100000000000000000000000000000000000001
100000000000000000000000000000000000001
100000000000000000001000001000000000001
100000000000000000000000000000000000001
100100000100000000010000010000000000001
100000000000000000000000000000000000001
100000000000000000000000000000000000001
100000010000010000000000000000000000001
100000000000000000000000000000000000001
100000000000000000000000000000000000001
100000000000010000010000000000000000001
100000000000000000000000000000000000001
111111111111111111111111111111111111111